3,9,9,9,9,9,9,9,9,9,9,9,9,9,4
8,0,0,0,0,0,0,0,0,0,0,0,0,0,10
8,0,0,0,0,0,0,0,0,0,0,0,0,0,10
8,0,0,0,0,0,0,0,0,0,0,0,0,0,10
8,0,0,0,2,0,0,0,0,0,0,0,0,0,10
8,0,0,0,0,0,2,0,0,0,0,0,0,0,10
8,0,0,0,0,0,0,0,0,0,0,2,0,0,10
8,0,0,0,2,0,0,2,0,0,0,0,0,0,10
8,0,0,0,0,0,0,0,0,0,0,0,0,0,10
8,0,0,0,0,0,2,0,0,0,2,0,0,0,10
8,0,0,0,0,0,0,0,0,0,0,0,0,0,10
8,0,0,0,0,0,0,0,0,0,0,0,0,0,10
8,0,0,0,0,0,0,0,0,0,0,2,0,0,10
8,0,0,0,0,0,0,0,0,0,0,0,0,0,10
6,7,7,7,7,7,7,7,7,7,7,7,7,7,10